mLLLLLLm
m.p....m
m.BBBTBm
m.B.B.Bm
m....OBm
m.BBB.Bm
m.....Bm
mLLLLLLm
